XXXXXXXXXXXXXXXXXXXXXXXXXXXXXXXX
X..a........XX.b..XXXXXXXXXXXXXX
X..XX......X.XXX.XXXXXXXXXXXXXXX
X.......XXX.......XXXXXXXXXXXXXX
X..............................X
X..XX...........XXXXXXXXXXXXXX.X
X....XX.X.XXX...XdXXXXXXXXXXXX.X
X..XX...........XXXXXXXXXXXXXX.X
X.................XXXXXXXXXXXX.X
X.....XXXXX..e....XXXXXXXXXXXX.X
X......XXX.........XXXXXXXXXXX.X
X.......X..........XXXXXXXXXX.XX
X.c....X..XX...XX..........f.XXX
X.....XXX..........XXXXXXXXXXXXX
XXXXXXXXXXXXXXXXXXXXXXXXXXXXXXXX
