EEEEEEEEEEEEEEEEEEEEEEEEEEEEEEEEEEEEEEEE
EAAAAAAAAAAAAAAAAAAAAAAAAAAAAAAFFAAAAAAE
EAAAAAAAAAAAAAAAAAAAAAAAAAAAAAAFFAAAAAAE
EEEEEEEEEEEEEEEEEEEAAAAEEEEEAAAFFAAA1AAE
EWWWWWEAAAAAAAAAAAEAAAAAAEAAAAAFFAAAAAAE
EWWW5WEAAAAAAAAAAAEAAAAAAEAAAAAFFAAAAAAE
EWWWWWEAAAAAAAAAAAEAAAAAAEAAAAFFFFAAAAAE
EWWWWWEA0AAAAAAAAAEAAAAAAEAAAAFFFFAAAAAE
EWWWWWEEEEEEEEAAAAEAAAAAAEAAAAFFFFAAAAAE
EWWWWWEAAAAAAAAAAAEAAA3AAEAAAFFFFFFAAAAE
EWWWWWEAAAAAAAAAAAEAEEEEAEAAAFFFFFFAAAAE
EWWWWWEAAAAAAAAAAAEAAAAAAEAAAFFFFFFAAAAE
EWWWWWEAAAAAAAAAAAEAAAAAAEAAFFFFFFFFAAAE
EWWWWWEAAAAAAAAAAAEAAAAAAEAAFFFFFFFFAAAE
EWWWWWE4AAAAAAAAAAEAAAAAAEAAFFFFFFFFAAAE
EWWWWWEEAEEEAAAAAAEAAAAAAEAFFFFFFFFFFAAE
EWWWWWEEAAAAEEEAAAAAAAAAAEAFFFFFFFFFFAAE
EWWWWWEEAAAAAAAAAAEAAAAAAEAFFFFFFFFFFAAE
EWWWWWEEEEEEEEEEEEEWWWWWWEFFFFFFFFFFFFFE
EWWWWWWWWWWWWWWWWWWWWWWWWEFFFFFFFFFFFFFE
EWWWWWWWWWWWWWWWWWWWWWWWWEFFFFFFFFFFFFFE
EWWWWW2WWWWWWWWWWWWWWWWWWEFFFFFFFFFFFFFE
EEEEEEEEEEEEEEEEEEEEEEEEEEEEEEEEEEEEEEEE
